1111111
1P10001
1E100C1
1000001
1111111