11111111111111111111111111111111111
100000000000000000000000000CC000001
100000000000000000000000000CC000001
1E000000000000000000000000000000001
101C0000000000000000000000000000P01
11111111111111111111111111111111111