111111111111111111111111111111111111111
100000000000000000000CCC000001CC0000001
100010100000000000000C0C000001CC0111101
100010100000000000000CCC00000100000C101
10001010000000000000000000000100000C101
10001C100000000000111000000001C00011101
1000101000000000001C10000000C1CC0010001
1000101000000000001C1000000001111110001
10001C111111111111101000000000CC0000001
100010100000000000101000000000CC0000001
10001010111111111C000000000000000000001
10001C10000000000000000E000000000000001
1111101001111111110000000000C0000000001
1CC000100100000001000000000011111111111
1C000010010111CCC100000000001CC00000001
10000010010111111100000000001C000000001
1000001001000000000000000000000000000P1
111111111111111111111111111111111111111
